    #####
    #   #
    #   #
  ###   ##
  #      #
### # ## #   
#   # ## ##########
# $  $          ..#
##### ### #@#######
    #     ###
    #######
